%,%,%,%,%,%,%,%,%,%,%,%,%,%,%,%,%,%,%,%,%,%,%,%,%,%,%,%
%,-,-,-,-,-,-,-,-,-,-,-,-,%,%,-,-,-,-,-,-,-,-,-,-,-,-,%
%,-,%,%,%,%,-,%,%,%,%,%,-,%,%,-,%,%,%,%,%,-,%,%,%,%,-,%
%,.,%,%,%,%,-,%,%,%,%,%,-,%,%,-,%,%,%,%,%,-,%,%,%,%,-,%
%,-,%,%,%,%,-,%,%,%,%,%,-,%,%,-,%,%,%,%,%,-,%,%,%,%,-,%
%,-,-,-,-,-,-,-,-,-,-,-,-,-,-,-,-,-,-,-,-,-,-,-,-,-,-,%
%,-,%,%,%,%,-,%,%,-,%,%,%,%,%,%,%,%,-,%,%,-,%,%,%,%,-,%
%,-,%,%,%,%,-,%,%,-,%,%,%,%,%,%,%,%,-,%,%,-,%,%,%,%,-,%
%,-,-,-,-,-,-,%,%,-,-,-,-,%,%,-,-,-,-,%,%,-,-,-,-,-,-,%
%,%,%,%,%,%,-,%,%,%,%,%,-,%,%,-,%,%,%,%,%,-,%,%,%,%,%,%
%,%,%,%,%,%,-,%,%,%,%,%,-,%,%,-,%,%,%,%,%,-,%,%,%,%,%,%
%,%,%,%,%,%,-,%,-,-,-,-,-,-,-,-,-,-,-,-,%,-,%,%,%,%,%,%
%,%,%,%,%,%,-,%,-,%,%,%,%,-,-,%,%,%,%,-,%,-,%,%,%,%,%,%
%,-,-,-,-,-,-,-,-,%,-,-,-,-,-,-,-,-,%,-,-,-,-,-,-,-,-,%
%,%,%,%,%,%,-,%,-,%,%,%,%,%,%,%,%,%,%,-,%,-,%,%,%,%,%,%
%,%,%,%,%,%,-,%,-,-,-,-,-,-,-,-,-,-,-,-,%,-,%,%,%,%,%,%
%,%,%,%,%,%,-,%,-,%,%,%,%,%,%,%,%,%,%,-,%,-,%,%,%,%,%,%
%,-,-,-,-,-,-,-,-,-,-,-,-,%,%,-,-,-,-,-,-,-,-,-,-,-,-,%
%,-,%,%,%,%,-,%,%,%,%,%,-,%,%,-,%,%,%,%,%,-,%,%,%,%,-,%
%,-,%,%,%,%,-,%,%,%,%,%,-,%,%,-,%,%,%,%,%,-,%,%,%,%,-,%
%,-,-,-,%,%,-,-,-,-,-,-,-,-,-,-,-,-,-,-,-,-,%,%,-,-,-,%
%,%,%,-,%,%,-,%,%,-,%,%,%,%,%,%,%,%,-,%,%,-,%,%,-,%,%,%
%,%,%,-,%,%,-,%,%,-,%,%,%,%,%,%,%,%,-,%,%,-,%,%,-,%,%,%
%,-,-,-,-,-,-,%,%,-,-,-,-,%,%,-,-,-,-,%,%,-,-,-,-,-,-,%
%,-,%,%,%,%,%,%,%,%,%,%,-,%,%,-,%,%,%,%,%,%,%,%,%,%,-,%
%,-,-,-,-,-,-,-,-,-,-,-,-,P,-,-,-,-,-,-,-,-,-,-,-,-,-,%
%,%,%,%,%,%,%,%,%,%,%,%,%,%,%,%,%,%,%,%,%,%,%,%,%,%,%,%