%,%,%,%,%,%,%,%,%,%,%,%,%,%,%,%,%,%,%,%
%,-,-,-,-,-,-,-,-,-,-,-,-,-,-,%,-,-,-,%
%,-,%,%,-,%,%,-,%,%,-,%,%,-,%,%,-,%,-,%
%,-,-,-,-,-,-,-,-,P,-,-,-,-,-,-,-,%,-,%
%,%,%,%,%,%,%,%,%,%,%,%,%,%,%,%,%,%,-,%
%,.,-,-,-,-,-,-,-,-,-,-,-,-,-,-,-,-,-,%
%,%,%,%,%,%,%,%,%,%,%,%,%,%,%,%,%,%,%,%