%,%,%,%,%,%,%,%,%,%,%,%,%,%,%,%,%,%,%,%
%,-,-,-,-,%,-,-,-,-,-,-,-,-,%,-,-,-,-,%
%,-,%,%,-,%,-,%,%,-,-,%,%,-,%,.,%,%,-,%
%,-,%,-,-,-,-,-,%,-,-,%,-,-,-,-,-,%,-,%
%,-,%,-,%,%,-,%,%,-,-,%,%,-,%,%,-,%,-,%
%,-,-,-,-,-,-,-,-,-,-,-,%,-,%,-,-,-,-,%
%,-,%,-,-,-,-,%,%,%,%,%,%,-,%,-,-,%,-,%
%,-,%,-,-,-,-,%,-,-,-,-,%,-,%,-,-,%,-,%
%,-,%,-,-,-,-,%,-,%,%,%,%,-,%,-,-,%,-,%
%,-,%,-,-,-,-,-,-,-,-,-,-,-,%,-,-,%,-,%
%,-,%,%,-,%,-,%,%,%,%,%,%,-,%,-,%,%,-,%
%,-,-,-,-,%,-,-,-,P,-,-,-,-,%,-,-,-,-,%
%,%,%,%,%,%,%,%,%,%,%,%,%,%,%,%,%,%,%,%